####################################
#..................................#
#..................................#
#..#............................#..#
#..##############################..#
#..................................#
#..........#............#..........#
#..######..##############..######..#
#..#............................#..#
#..#............................#..#
#..#............................#..#
#..#............................#..#
#..#............................#..#
#..#............................#..#
#..#............................#..#
#..#............................#..#
#..#............................#..#
#..#............................#..#
#..######..##############..######..#
#..........#............#..........#
#..................................#
#..##############################..#
#..#............................#..#
#..................................#
#..................................#
####################################
