####################################
#..................................#
#..................................#
#..................................#
#..##############################..#
#..................................#
#..................................#
#..#............................#..#
#..#............................#..#
#..#............................#..#
#..#............................#..#
#..#............................#..#
#..#............................#..#
#..#............................#..#
#..#............................#..#
#..#............................#..#
#..#............................#..#
#..#............................#..#
#..#............................#..#
#..................................#
#..................................#
#..##############################..#
#..................................#
#..................................#
#..................................#
####################################
