##############...##...##############
#................##................#
#................##................#
.................##.................
.................##.................
#................##................#
#................##................#
####################################
###########..............###########
###########..............###########
###########..............###########
###########..............###########
###########..............###########
###########..............###########
###########..............###########
###########..............###########
###########..............###########
###########..............###########
###########..............###########
################....################
#..................................#
#..................................#
....................................
#................##................#
#................##................#
##############...##...##############
